//MAP CONVERTED BY dmm2tgm.py THIS HEADER COMMENT PREVENTS RECONVERSION, DO NOT REMOVE
"a" = (
/turf/open/space/basic,
/area/space)
"b" = (
/obj/machinery/porta_turret/ai,
/turf/open/floor/plating/airless,
/area/ruin/space/tcommsat_oldaisat)
"d" = (
/obj/structure/lattice/catwalk,
/obj/structure/cable,
/turf/open/space/basic,
/area/ruin/space/tcommsat_oldaisat)
"f" = (
/obj/machinery/door/airlock/vault{
	id_tag = "sinclair_ai_core_doorbolts";
	name = "AI Core Access"
	},
/obj/structure/cable,
/obj/effect/mapping_helpers/airlock/locked,
/obj/effect/mapping_helpers/airlock/access/all/away/command,
/turf/open/floor/iron,
/area/ruin/space/tcommsat_oldaisat)
"h" = (
/obj/structure/cable,
/turf/open/floor/iron,
/area/ruin/space/tcommsat_oldaisat)
"i" = (
/turf/open/floor/iron,
/area/ruin/space/tcommsat_oldaisat)
"j" = (
/obj/structure/window/reinforced/spawner/directional/west,
/turf/open/misc/asteroid,
/area/ruin/space/tcommsat_oldaisat)
"k" = (
/obj/machinery/power/tracker,
/obj/structure/cable,
/turf/open/floor/iron/solarpanel/airless,
/area/ruin/space/tcommsat_oldaisat)
"l" = (
/obj/machinery/door/airlock/external/ruin,
/obj/structure/cable,
/obj/effect/mapping_helpers/airlock/access/all/away/engineering,
/turf/open/floor/iron,
/area/ruin/space/tcommsat_oldaisat)
"m" = (
/turf/closed/mineral/asteroid,
/area/space)
"n" = (
/obj/machinery/door/window/right/directional/west,
/obj/structure/cable,
/obj/machinery/power/apc/auto_name/directional/south,
/obj/effect/mapping_helpers/apc/away_general_access,
/obj/effect/mapping_helpers/apc/cell_5k,
/obj/effect/mapping_helpers/apc/full_charge,
/turf/open/floor/circuit,
/area/ruin/space/tcommsat_oldaisat)
"p" = (
/obj/machinery/power/solar,
/obj/structure/cable,
/turf/open/floor/iron/solarpanel/airless,
/area/ruin/space/tcommsat_oldaisat)
"q" = (
/obj/machinery/button/door/directional/south{
	normaldoorcontrol = 1;
	name = "Door Bolts";
	id = "sinclair_ai_core_doorbolts"
	},
/turf/open/floor/iron,
/area/ruin/space/tcommsat_oldaisat)
"r" = (
/turf/open/misc/asteroid,
/area/ruin/space/has_grav/atmosasteroid)
"t" = (
/obj/machinery/power/solar_control,
/obj/structure/cable,
/turf/open/floor/iron,
/area/ruin/space/tcommsat_oldaisat)
"u" = (
/obj/machinery/door/airlock/external/ruin,
/obj/effect/mapping_helpers/airlock/access/all/away/engineering,
/turf/open/floor/iron,
/area/ruin/space/tcommsat_oldaisat)
"z" = (
/obj/structure/ai_core/deactivated{
	desc = "This core has a Cybersun serial number on the side... But it seems the ai isn't home."
	},
/obj/structure/cable,
/turf/open/floor/circuit,
/area/ruin/space/tcommsat_oldaisat)
"A" = (
/obj/structure/lattice/catwalk,
/obj/structure/cable,
/turf/open/misc/asteroid,
/area/ruin/space/has_grav/atmosasteroid)
"B" = (
/obj/structure/cable,
/turf/open/floor/glass/reinforced,
/area/ruin/space/tcommsat_oldaisat)
"G" = (
/turf/closed/wall/r_wall,
/area/ruin/space/tcommsat_oldaisat)
"H" = (
/obj/machinery/power/smes,
/obj/structure/cable,
/turf/open/floor/iron,
/area/ruin/space/tcommsat_oldaisat)
"J" = (
/obj/machinery/power/terminal{
	dir = 4
	},
/obj/structure/cable,
/turf/open/floor/iron,
/area/ruin/space/tcommsat_oldaisat)
"L" = (
/obj/structure/cable,
/obj/machinery/turretid{
	pixel_x = 0;
	pixel_y = -24;
	control_area = /area/ruin/space/tcommsat_oldaisat
	},
/turf/open/floor/circuit,
/area/ruin/space/tcommsat_oldaisat)
"O" = (
/obj/structure/window/reinforced/spawner/directional/east,
/turf/open/misc/asteroid,
/area/ruin/space/tcommsat_oldaisat)
"P" = (
/turf/closed/mineral/asteroid,
/area/ruin/space/has_grav/atmosasteroid)
"R" = (
/turf/open/misc/asteroid,
/area/ruin/space/tcommsat_oldaisat)
"S" = (
/obj/machinery/door/airlock/engineering,
/obj/effect/mapping_helpers/airlock/access/all/away/engineering,
/turf/open/floor/iron,
/area/ruin/space/tcommsat_oldaisat)
"T" = (
/obj/structure/grille/broken,
/turf/open/space/basic,
/area/space)
"W" = (
/obj/structure/grille,
/turf/open/space/basic,
/area/space)
"Z" = (
/obj/machinery/door/window/right/directional/east,
/turf/open/floor/circuit,
/area/ruin/space/tcommsat_oldaisat)

(1,1,1) = {"
a
a
a
a
a
a
a
a
a
a
a
a
a
a
a
a
a
a
a
a
a
a
a
a
a
a
a
a
a
a
a
a
a
"}
(2,1,1) = {"
a
a
a
a
a
a
a
a
a
a
a
a
a
a
a
a
a
a
a
a
a
a
a
a
a
a
a
a
m
m
m
a
a
"}
(3,1,1) = {"
a
a
a
a
a
a
a
a
a
a
a
a
a
a
a
a
a
a
a
a
a
a
a
a
a
a
a
m
m
m
m
m
a
"}
(4,1,1) = {"
a
a
a
a
a
a
a
a
a
a
a
a
a
a
a
a
a
a
a
a
a
a
a
a
a
a
a
m
m
m
m
m
a
"}
(5,1,1) = {"
a
a
a
a
a
a
P
P
P
a
P
a
a
P
P
a
a
a
a
r
a
P
P
P
P
a
a
a
m
m
m
m
a
"}
(6,1,1) = {"
a
a
a
a
a
P
P
P
P
P
P
P
a
P
P
P
r
r
P
r
P
P
P
P
P
P
a
a
m
m
m
a
a
"}
(7,1,1) = {"
a
a
a
a
P
P
P
P
P
P
P
P
P
P
P
P
P
P
P
P
P
P
P
P
P
P
a
a
a
m
a
a
a
"}
(8,1,1) = {"
a
a
P
P
P
P
P
P
P
r
P
P
P
P
P
P
P
P
P
P
P
P
P
P
P
P
a
a
a
a
a
a
a
"}
(9,1,1) = {"
a
a
P
P
P
P
G
G
G
G
G
G
G
G
G
G
G
G
G
G
G
G
G
G
G
P
P
a
a
a
a
a
a
"}
(10,1,1) = {"
a
a
a
P
P
P
G
i
i
i
i
i
i
i
i
i
i
i
i
i
i
i
i
i
G
P
P
P
a
a
a
a
a
"}
(11,1,1) = {"
a
a
a
P
P
P
G
i
i
G
G
G
G
G
G
G
G
G
G
G
G
G
i
i
G
P
P
a
a
a
a
a
a
"}
(12,1,1) = {"
a
a
P
P
P
P
G
i
i
G
m
m
m
m
m
m
m
m
m
m
m
G
i
i
G
P
a
a
a
a
a
a
a
"}
(13,1,1) = {"
a
a
a
P
P
P
G
i
i
G
G
G
G
G
G
G
G
m
m
m
m
G
i
i
G
P
P
a
a
a
a
a
a
"}
(14,1,1) = {"
a
a
a
P
P
P
G
i
i
G
G
h
h
h
h
i
G
m
m
m
m
G
i
i
G
P
P
a
a
a
a
a
a
"}
(15,1,1) = {"
a
a
P
P
P
P
G
i
i
G
G
J
i
i
h
i
G
G
G
G
G
G
i
i
G
P
P
a
a
a
a
a
a
"}
(16,1,1) = {"
a
P
P
P
P
P
G
i
i
G
G
H
h
i
h
i
G
b
R
R
b
G
i
i
G
r
r
P
a
a
a
a
a
"}
(17,1,1) = {"
a
P
P
P
G
G
G
i
i
G
G
G
n
G
h
q
G
O
O
O
O
G
i
i
G
P
a
a
a
a
a
a
a
"}
(18,1,1) = {"
P
P
r
r
u
i
u
i
i
G
G
z
L
G
h
h
f
B
B
B
B
f
h
i
G
P
P
P
a
a
a
a
a
"}
(19,1,1) = {"
P
r
r
P
G
G
G
i
i
G
G
G
Z
G
h
i
G
j
j
j
j
G
h
i
G
P
P
a
a
a
a
a
a
"}
(20,1,1) = {"
P
r
P
P
P
P
G
i
i
G
G
t
h
h
h
i
G
b
R
R
b
G
h
i
G
P
P
a
a
a
a
a
a
"}
(21,1,1) = {"
a
r
P
P
P
P
G
i
i
G
G
i
i
i
i
i
G
G
G
G
G
G
h
i
G
P
a
a
a
a
a
a
a
"}
(22,1,1) = {"
a
P
P
P
P
P
G
i
i
G
G
i
i
i
i
i
G
m
m
m
m
G
h
i
G
P
P
a
a
a
a
a
a
"}
(23,1,1) = {"
a
a
P
P
P
P
G
i
i
G
G
G
G
G
G
G
G
m
m
m
m
G
h
i
G
P
P
a
a
a
a
a
a
"}
(24,1,1) = {"
a
a
r
P
P
P
G
i
i
G
m
m
m
m
m
m
m
m
m
m
m
G
h
i
G
P
P
P
a
a
a
a
a
"}
(25,1,1) = {"
a
a
a
P
P
P
G
i
i
G
G
G
G
G
G
G
G
G
G
G
G
G
h
i
G
P
P
P
a
a
a
a
a
"}
(26,1,1) = {"
a
a
P
P
P
P
G
i
i
i
i
i
i
i
h
h
h
h
h
h
h
h
h
i
G
P
P
P
P
a
a
a
a
"}
(27,1,1) = {"
a
P
P
P
P
P
G
G
G
G
G
G
G
G
l
G
G
G
G
G
G
G
S
S
G
P
P
P
P
P
a
a
a
"}
(28,1,1) = {"
a
P
P
P
P
P
P
P
P
P
P
P
r
G
h
G
P
P
P
G
i
i
i
i
G
G
G
P
P
P
P
a
a
"}
(29,1,1) = {"
a
P
P
P
P
P
P
P
P
P
r
r
r
G
l
G
P
P
P
G
i
i
i
i
i
i
G
P
P
a
a
a
a
"}
(30,1,1) = {"
a
a
P
P
P
P
P
P
P
r
r
r
r
r
A
r
P
P
P
G
i
i
i
i
i
i
G
P
P
a
a
a
a
"}
(31,1,1) = {"
a
a
P
P
W
a
P
P
r
r
a
a
r
r
A
r
P
P
P
G
i
i
i
i
i
i
G
P
P
a
a
a
a
"}
(32,1,1) = {"
a
a
a
a
W
a
p
p
p
a
p
p
p
a
d
r
P
P
P
G
i
i
i
i
i
i
G
P
P
a
a
a
a
"}
(33,1,1) = {"
a
a
a
a
W
a
d
d
d
d
d
d
d
d
d
P
P
P
P
G
i
i
i
i
i
i
G
P
P
a
a
a
a
"}
(34,1,1) = {"
a
a
a
a
W
a
p
p
p
a
p
p
p
a
d
r
P
P
P
G
i
i
i
i
i
i
G
P
P
a
a
a
a
"}
(35,1,1) = {"
a
a
a
a
W
a
a
a
a
a
a
a
a
a
d
r
P
P
P
G
G
G
G
G
G
G
G
P
a
a
a
a
a
"}
(36,1,1) = {"
a
a
a
a
W
a
p
p
p
a
p
p
p
a
d
a
P
P
P
P
P
P
P
P
P
P
P
P
a
a
a
a
a
"}
(37,1,1) = {"
a
a
a
a
W
a
d
d
d
d
d
d
d
d
d
P
P
P
P
P
P
P
P
P
a
a
a
a
a
a
a
a
a
"}
(38,1,1) = {"
a
a
a
a
W
a
p
p
p
a
p
p
p
a
d
a
a
P
P
P
P
P
P
P
a
a
a
a
a
a
a
a
a
"}
(39,1,1) = {"
a
a
a
a
W
a
a
a
a
a
a
a
a
a
d
a
P
P
P
P
a
a
a
a
a
a
a
a
a
a
a
a
a
"}
(40,1,1) = {"
a
a
a
a
W
a
p
p
p
a
p
p
p
a
d
a
W
a
a
a
a
a
a
a
a
a
a
a
a
a
a
a
a
"}
(41,1,1) = {"
a
a
a
a
W
a
d
d
d
d
d
d
d
d
d
a
W
a
a
a
a
a
a
m
m
a
a
a
a
a
a
a
a
"}
(42,1,1) = {"
a
a
a
a
W
a
p
p
p
a
p
p
p
a
d
a
W
a
a
a
a
a
m
m
m
m
a
a
a
a
a
a
a
"}
(43,1,1) = {"
a
m
m
a
W
a
a
a
a
a
a
a
a
a
d
a
W
a
a
a
a
a
m
m
m
m
a
a
a
a
a
a
a
"}
(44,1,1) = {"
m
m
m
a
T
a
a
a
a
a
a
a
a
a
k
a
W
a
a
a
a
a
a
m
m
m
a
a
a
a
a
a
a
"}
(45,1,1) = {"
m
m
m
m
T
W
W
W
T
W
W
W
W
W
W
T
W
a
a
a
a
a
a
a
a
a
a
a
a
a
a
a
a
"}
(46,1,1) = {"
a
m
m
m
m
a
a
a
a
a
a
a
a
a
a
a
a
a
a
a
a
a
a
a
a
a
a
a
a
a
a
a
a
"}
(47,1,1) = {"
m
m
m
m
m
a
a
a
a
a
a
a
a
a
a
a
a
a
a
a
a
a
a
a
a
a
a
a
a
a
a
a
a
"}
(48,1,1) = {"
a
m
m
m
m
a
a
a
a
a
a
a
a
a
a
a
a
a
a
a
a
a
a
a
a
a
a
a
a
a
a
a
a
"}
(49,1,1) = {"
a
m
m
a
a
a
a
a
a
a
a
a
a
a
a
a
a
a
a
a
a
a
a
a
a
a
a
a
a
a
a
a
a
"}
(50,1,1) = {"
a
a
a
a
a
a
a
a
a
a
a
a
a
a
a
a
a
a
a
a
a
a
a
a
a
a
a
a
a
a
a
a
a
"}
(51,1,1) = {"
a
a
a
a
a
a
a
a
a
a
a
a
a
a
a
a
a
a
a
a
a
a
a
a
a
a
a
a
a
a
a
a
a
"}
(52,1,1) = {"
a
a
a
a
a
a
a
a
a
a
a
a
a
a
a
a
a
a
a
a
a
a
a
a
a
a
a
a
a
a
a
a
a
"}
